12 12
111111111111
111000000001
110020000221
100020000021
100211111001
102220201201
102000001201
100000001001
111122020021
112200002001
100020011001
111111111111