15 15
111111111111111
100000100000001
101110101010101
100010001010101
111011101011101
100000101010101
101110101010101
100010100010001
111011111010111
100000001000001
101010101011111
101010101010001
101010101110101
100000100000101
111111111111111
