20 30
111111111111111111111111111111
100000100010001000001000010001
100000000010001000000000010001
100000100000001000001000010001
111011100010001110111110110001
100000100010001000001000010001
100000111111011000001000011011
100000100010001000000000010001
100000000010001000001000000001
111011100010000000001000010001
100000100000001111111000010001
100000100010001000000000011111
100000000011011000001000010001
111111110110001000001111110001
100010000010001000000000010001
100010000000001111011000010001
100000000010001000001000000001
100010000010001000001000010001
100010000010001000001000010001
111111111111111111111111111111