20
20
11111111111111111111
11111111111111111111
11111111111111111111
11111111111111111111
11111111111111111111
11111111111111111111
11111100000000111111
11111100000000111111
11111100200200111111
11111100000000111111
11111100000000111111
11111100000000111111
11111111101111111111
11111100000000111111
11111111111111111111
11111111111111111111
11111111111111111111
11111111111111111111
11111111111111111111
11111111111111111111
