12 12
111111111111
111000000001
110000000001
100000000001
100011111001
100000001001
100000001001
100000001001
111100000001
110000000001
100000011001
111111111111